text	label
Wie kann man eine Partnerschaft mit der HNU aufbauen?	partnership_inquiry
Verfügbare Partnerschaftsmöglichkeiten	partnership_inquiry
Ich möchte eine Partnerschaft mit Ihrer Universität eingehen	partnership_inquiry
Was sind die Partnerschaftsanforderungen?	partnership_inquiry
Wie wird man strategischer Partner?	partnership_inquiry
Partnerschaftsantragsprozess	partnership_inquiry
Arten von angebotenen Partnerschaften	partnership_inquiry
Industriepartnerschaftsmöglichkeiten	partnership_inquiry
Akademische Partnerschaftsprogramme	partnership_inquiry
Forschungspartnerschaftsmöglichkeiten	partnership_inquiry
Internationale Partnerschaftsoptionen	partnership_inquiry
Vorteile der Unternehmenspartnerschaft	partnership_inquiry
Partnerschaftsvertragsvorlagen	partnership_inquiry
Partnerschaftsbewertungskriterien	partnership_inquiry
Langfristige Partnerschaftsentwicklung	partnership_inquiry
Partnerschaftsverlängerungsprozess	partnership_inquiry
Partnerschaftsgebührenstruktur	partnership_inquiry
Partnerschafts-Compliance-Anforderungen	partnership_inquiry
Partnerschaftsleistungsmetriken	partnership_inquiry
Partnerschaftsbeendigungsverfahren	partnership_inquiry
Rechtliche Partnerschaftsanforderungen	partnership_inquiry
Partnerschaft-Urheberrechte	partnership_inquiry
Partnerschafts-Vertraulichkeitsvereinbarungen	partnership_inquiry
Partnerschaftshaftungsüberlegungen	partnership_inquiry
Partnerschafts-Governance-Struktur	partnership_inquiry
Partnerschaftskommunikationsprotokolle	partnership_inquiry
Partnerschaftsberichtspflichten	partnership_inquiry
Partnerschaftsprüfungsverfahren	partnership_inquiry
Partnerschaftsstreitbeilegung	partnership_inquiry
Partnerschaftserfolgsgeschichten	partnership_inquiry
Forschungskooperationsmöglichkeiten	collaboration_opportunities
Gemeinsame Projektvorschläge	collaboration_opportunities
Kollaborative Forschungsprogramme	collaboration_opportunities
Industrie-Akademie-Kooperation	collaboration_opportunities
Internationale Kooperationsprojekte	collaboration_opportunities
Sektorübergreifende Partnerschaften	collaboration_opportunities
Innovations-Kooperationsinitiativen	collaboration_opportunities
Technologietransfer-Partnerschaften	collaboration_opportunities
Wissensaustauschprogramme	collaboration_opportunities
Kollaborative Finanzierungsmöglichkeiten	collaboration_opportunities
Gemeinsame Forschungsstipendien	collaboration_opportunities
Kollaborative Veröffentlichungen	collaboration_opportunities
Gemeinsam genutzte Forschungseinrichtungen	collaboration_opportunities
Gemeinsamer Laborzugang	collaboration_opportunities
Kollaborative Forschungsvereinbarungen	collaboration_opportunities
Multi-Partner-Forschungskonsortien	collaboration_opportunities
Kollaborative Innovationsprojekte	collaboration_opportunities
Gemeinsame Technologieentwicklung	collaboration_opportunities
Kollaborative Ausbildungsprogramme	collaboration_opportunities
Gemeinsame Experteninitiativen	collaboration_opportunities
Gemeinsame Konferenzorganisation	collaboration_opportunities
Kollaborative Workshops	collaboration_opportunities
Gemeinsame Symposiumsplanung	collaboration_opportunities
Kollaborative Wissensschaffung	collaboration_opportunities
Gemeinsame Forschungsmethodik	collaboration_opportunities
Kollaborative Datenteilung	collaboration_opportunities
Gemeinsames geistiges Eigentum	collaboration_opportunities
Kollaborative Forschungsethik	collaboration_opportunities
Gemeinsame Forschungsbetreuung	collaboration_opportunities
Kollaborative Abschlussprojekte	collaboration_opportunities
Wie organisiert man Veranstaltungen an der HNU?	event_planning
Veranstaltungsortbuchung	event_planning
Konferenzraum-Vermietung	event_planning
Workshop-Raumverfügbarkeit	event_planning
Veranstaltungsplanungsservices	event_planning
Catering für Veranstaltungen	event_planning
Audio-visuelle Gerätemiete	event_planning
Veranstaltungssicherheitsdienste	event_planning
Parken für Veranstaltungsgäste	event_planning
Veranstaltungsmarketing-Unterstützung	event_planning
Veranstaltungsregistrierungssysteme	event_planning
Corporate Event Hosting	event_planning
Akademische Konferenzorganisation	event_planning
Seminarraumreservierungen	event_planning
Verfügbarkeit großer Veranstaltungsorte	event_planning
Veranstaltungsaufbau-Anforderungen	event_planning
Veranstaltungsreinigungsservices	event_planning
Veranstaltungsversicherungsanforderungen	event_planning
Veranstaltungsgenehmigungsverfahren	event_planning
Veranstaltungskostenberechnungen	event_planning
Veranstaltungsausrüstungsbedarf	event_planning
Veranstaltungspersonal-Unterstützung	event_planning
Veranstaltungstechnologie-Anforderungen	event_planning
Veranstaltungsbarrierefreiheits-Features	event_planning
Veranstaltungsaufzeichnungsservices	event_planning
Veranstaltungs-Live-Streaming	event_planning
Veranstaltungsfotografie-Services	event_planning
Veranstaltungswerbematerialien	event_planning
Veranstaltungssponsoring-Möglichkeiten	event_planning
Veranstaltungsfeedback-Sammlung	event_planning
Lieferantenregistrierungsprozess	vendor_services
Lieferantenqualifikationsanforderungen	vendor_services
Beschaffungsverfahren	vendor_services
Vertragsausschreibungsprozess	vendor_services
Lieferantenzahlungsbedingungen	vendor_services
Dienstleisteranträge	vendor_services
Lieferanten-Compliance-Anforderungen	vendor_services
Lieferantendiversitätsprogramme	vendor_services
Lieferantenleistungsbewertung	vendor_services
Beschaffungsrichtlinieninformationen	vendor_services
Lieferantenrechnungsverfahren	vendor_services
Service-Level-Vereinbarungen	vendor_services
Lieferanten-Onboarding-Prozess	vendor_services
Lieferantenprüfungsanforderungen	vendor_services
Lieferantenversicherungsanforderungen	vendor_services
Beschaffungsausschreibungsprozess	vendor_services
Lieferantenvertragsmanagement	vendor_services
Lieferantenbeziehungsmanagement	vendor_services
Lieferantenstreitbeilegung	vendor_services
Beschaffungsethik-Richtlinien	vendor_services
Lieferantenzertifizierungsanforderungen	vendor_services
Lieferantennachhaltigkeitsstandards	vendor_services
Lieferantendatensicherheitsanforderungen	vendor_services
Beschaffungsrisikomanagement	vendor_services
Lieferantenleistungsmetriken	vendor_services
Lieferantenqualitätsstandards	vendor_services
Lieferantenverlängerungsverfahren	vendor_services
Beschaffungstransparenzanforderungen	vendor_services
Lieferantenbeendigungsverfahren	vendor_services
Lieferanteninnovationsprogramme	vendor_services
Gemeinsame Forschungsvorschläge	research_partnerships
Forschungsfinanzierungsmöglichkeiten	research_partnerships
Kollaborative Forschungsstipendien	research_partnerships
Industrieforschungspartnerschaften	research_partnerships
Forschungseinrichtungszugang	research_partnerships
Gemeinsame PhD-Programme	research_partnerships
Forschungsausrüstungsteilung	research_partnerships
Gemeinsame Forschungsveröffentlichungen	research_partnerships
Forschungsdatenteilungsvereinbarungen	research_partnerships
Forschungskooperationsrahmen	research_partnerships
Interdisziplinäre Forschung	research_partnerships
Internationale Forschungspartnerschaften	research_partnerships
Forschungskommerzialisierungsmöglichkeiten	research_partnerships
Technologietransferprogramme	research_partnerships
Forschungs-Spin-off-Unterstützung	research_partnerships
Gemeinsame Forschungszentren	research_partnerships
Forschungssabbatprogramme	research_partnerships
Gastforscherprogramme	research_partnerships
Forschungsmentoring-Möglichkeiten	research_partnerships
Forschungsnetzwerkveranstaltungen	research_partnerships
Forschungskonferenzpartnerschaften	research_partnerships
Forschungsworkshop-Kooperationen	research_partnerships
Gemeinsame Forschungssymposien	research_partnerships
Forschungsausbildungspartnerschaften	research_partnerships
Forschungskapazitätsaufbau	research_partnerships
Forschungsinfrastrukturteilung	research_partnerships
Forschungsmethodikaustausch	research_partnerships
Forschungs-Best-Practices-Austausch	research_partnerships
Forschungsauswirkungsbewertung	research_partnerships
Forschungsnachhaltigkeitsinitiativen	research_partnerships
Studentenaustauschprogramme	student_exchange
Internationale Studentenmobilität	student_exchange
Austauschprogramm-Anforderungen	student_exchange
Studentenplatzierungsmöglichkeiten	student_exchange
Austauschstudenten-Unterstützungsdienste	student_exchange
Akademische Creditübertragung	student_exchange
Austauschprogrammdauer	student_exchange
Austauschstudentenunterkunft	student_exchange
Austauschprogrammkosten	student_exchange
Austauschstudentenvisa	student_exchange
Sprachanforderungen für Austausch	student_exchange
Austauschprogramm-Bewerbungen	student_exchange
Kulturaustauschprogramme	student_exchange
Studienauslandspartnerschaften	student_exchange
Austauschstudenten-Orientierung	student_exchange
Austauschprogramm-Bewertung	student_exchange
Austauschstudenten-Mentoring	student_exchange
Austauschprogramm-Koordination	student_exchange
Internationale Austauschvereinbarungen	student_exchange
Austauschstudentenversicherung	student_exchange
Austauschprogramm-Überwachung	student_exchange
Austauschstudenten-Integration	student_exchange
Austauschprogramm-Qualitätssicherung	student_exchange
Austauschstudenten-Feedback	student_exchange
Austauschprogramm-Nachhaltigkeit	student_exchange
Austauschstudenten-Karrieredienste	student_exchange
Austauschprogramm-Alumni-Netzwerk	student_exchange
Austauschstudenten-Forschungsmöglichkeiten	student_exchange
Austauschprogramm-Partnerschaften	student_exchange
Austauschstudenten-Erfolgsgeschichten	student_exchange
Campus-Einrichtungsmiete	facility_rental
Konferenzraumbuchung	facility_rental
Auditorium-Mietverfügbarkeit	facility_rental
Laborraummiete	facility_rental
Sporteinrichtungsbuchung	facility_rental
Gerätemieteservices	facility_rental
Veranstaltungsort-Mietpreise	facility_rental
Einrichtungsbuchungsverfahren	facility_rental
Veranstaltungsraumverfügbarkeit	facility_rental
Besprechungsraumreservierungen	facility_rental
Klassenzimmer-Mietoptionen	facility_rental
Einrichtungsnutzungsrichtlinien	facility_rental
Mietvertragsbedingungen	facility_rental
Einrichtungssicherheitseinlagen	facility_rental
Mietstornierungsrichtlinien	facility_rental
Einrichtungswartungsservices	facility_rental
Mietgeräteinventar	facility_rental
Einrichtungsbarrierefreiheits-Features	facility_rental
Mietversicherungsanforderungen	facility_rental
Einrichtungsaufbauservices	facility_rental
Mietzahlungsbedingungen	facility_rental
Einrichtungsreinigungsservices	facility_rental
Mietdauergrenzen	facility_rental
Einrichtungskapazitätsinformationen	facility_rental
Mietbuchungszeitplan	facility_rental
Einrichtungstechnischer Support	facility_rental
Mietkundenservices	facility_rental
Einrichtungssicherheitsanforderungen	facility_rental
Mietschadensrichtlinien	facility_rental
Einrichtungsverfügbarkeitskalender	facility_rental
Technologie-Lizenzierungsmöglichkeiten	technology_transfer
Übertragung geistigen Eigentums	technology_transfer
Innovationskommerzialisierung	technology_transfer
Patentlizenzierungsvereinbarungen	technology_transfer
Technologiebewertungsservices	technology_transfer
Forschungskommerzialisierungsunterstützung	technology_transfer
Startup-Inkubationsprogramme	technology_transfer
Technologie-Scouting-Services	technology_transfer
Innovationspartnerschaftsprogramme	technology_transfer
Technologieentwicklungsfinanzierung	technology_transfer
Marktforschung für Technologien	technology_transfer
Technologiedemonstrationsmöglichkeiten	technology_transfer
Proof-of-Concept-Finanzierung	technology_transfer
Technologiebewertungsservices	technology_transfer
Lizenzierungsverhandlungsunterstützung	technology_transfer
Technologie-Due-Diligence	technology_transfer
Innovations-Ökosystem-Partnerschaften	technology_transfer
Technologietransfer-Training	technology_transfer
Schutz geistigen Eigentums	technology_transfer
Technologiemarketing-Unterstützung	technology_transfer
Innovationswettbewerbsprogramme	technology_transfer
Technologie-Showcase-Veranstaltungen	technology_transfer
Industrie-Technologiebedarf	technology_transfer
Technologie-Bereitschaftsbewertung	technology_transfer
Kommerzialisierungsstrategieentwicklung	technology_transfer
Technologietransfer-Erfolgsgeschichten	technology_transfer
Innovationsauswirkungsmessung	technology_transfer
Technologiepartnerschaftsvereinbarungen	technology_transfer
Innovationsfinanzierungsmöglichkeiten	technology_transfer
Technologietransfer-Best-Practices	technology_transfer
Allgemeine Universitätsinformationen	public_information
Campus-Führungsanfragen	public_information
Public-Relations-Anfragen	public_information
Medienkontaktinformationen	public_information
Universitätsstatistiken	public_information
Jahresbericht-Zugang	public_information
Universitätsleitbild	public_information
Informationen zu akademischen Programmen	public_information
Fakultätsexpertiseverzeichnis	public_information
Universitätsnews-Updates	public_information
Pressemitteilungsinformationen	public_information
Universitätserfolge	public_information
Akkreditierungsinformationen	public_information
Universitäts-Rankings	public_information
Alumni-Erfolgsgeschichten	public_information
Universitätsgeschichtsinformationen	public_information
Campus-Karte und Wegbeschreibungen	public_information
Öffentliche Vorlesungsreihen	public_information
Community-Engagement-Programme	public_information
Universitätssoziale Verantwortung	public_information
Nachhaltigkeitsinitiativen	public_information
Universitäts-Strategieplan	public_information
Qualitätssicherungsinformationen	public_information
Universitäts-Governance-Struktur	public_information
Öffentliche Zugangsrichtlinien	public_information
Universitätstransparenzberichte	public_information
Community-Partnerschaftsprogramme	public_information
Öffentliche Bekanntmachungen	public_information
Universitäts-Branding-Richtlinien	public_information
Externe Kommunikationsrichtlinien	public_information
Alumni-Netzwerkmöglichkeiten	alumni_relations
Alumni-Mentoring-Programme	alumni_relations
Alumni-Karriereservices	alumni_relations
Alumni-Veranstaltungskalender	alumni_relations
Alumni-Spendenmöglichkeiten	alumni_relations
Alumni-Freiwilligenprogramme	alumni_relations
Alumni-Verzeichniszugang	alumni_relations
Alumni-Vorteilsprogramme	alumni_relations
Alumni-Weiterbildung	alumni_relations
Alumni-Forschungskooperation	alumni_relations
Alumni-Erfolgsgeschichten-Austausch	alumni_relations
Alumni-Newsletter-Abonnement	alumni_relations
Alumni-Social-Media-Gruppen	alumni_relations
Alumni-Berufsentwicklung	alumni_relations
Alumni-Unternehmertum-Unterstützung	alumni_relations
Alumni-Industrieverbindungen	alumni_relations
Alumni-Internationales Netzwerk	alumni_relations
Alumni-Stipendienprogramme	alumni_relations
Alumni-Governance-Beteiligung	alumni_relations
Alumni-Beratungsgremium-Möglichkeiten	alumni_relations
Alumni-Treffen-Planung	alumni_relations
Alumni-Anerkennungsprogramme	alumni_relations
Alumni-Feedback-Sammlung	alumni_relations
Alumni-Partnerschaftsmöglichkeiten	alumni_relations
Alumni-Wissensteilung	alumni_relations
Alumni-Community-Aufbau	alumni_relations
Alumni-Vermächtnisprogramme	alumni_relations
Alumni-Auswirkungsmessung	alumni_relations
Alumni-Engagement-Strategien	alumni_relations
Alumni-Beziehungsmanagement	alumni_relations
Professionelle Beratungsdienstleistungen	consultation_services
Expertenberatungsservices	consultation_services
Technische Beratungsangebote	consultation_services
Industrieanalyseservices	consultation_services
Marktforschungsberatung	consultation_services
Technologiebewertungsservices	consultation_services
Geschäftsstrategieberatung	consultation_services
Innovationsberatungsservices	consultation_services
Forschungsmethodikberatung	consultation_services
Politikanalyseservices	consultation_services
Risikobewertungsberatung	consultation_services
Qualitätssicherungsberatung	consultation_services
Prozessverbesserungsservices	consultation_services
Nachhaltigkeitsberatung	consultation_services
Digitale Transformationsberatung	consultation_services
Change-Management-Beratung	consultation_services
Ausbildungs- und Entwicklungsservices	consultation_services
Machbarkeitsstudienservices	consultation_services
Due-Diligence-Beratung	consultation_services
Compliance-Beratungsservices	consultation_services
Leistungsbewertungsservices	consultation_services
Strategische Planungsberatung	consultation_services
Projektmanagementservices	consultation_services
Wissenstransferservices	consultation_services
Best-Practices-Beratung	consultation_services
Benchmarking-Services	consultation_services
Bewertungs- und Einschätzungsservices	consultation_services
Beratungsausschuss-Beteiligung	consultation_services
Sachverständigenservices	consultation_services
Professionelle Zertifizierungsunterstützung	consultation_services
Zuschussfinanzierungsmöglichkeiten	funding_opportunities
Forschungsfinanzierungsprogramme	funding_opportunities
Partnerschaftsfinanzierungsschemas	funding_opportunities
Innovationsfinanzierungsinitiativen	funding_opportunities
Kollaborative Projektfinanzierung	funding_opportunities
Internationale Finanzierungsprogramme	funding_opportunities
Regierungsfinanzierungsmöglichkeiten	funding_opportunities
Private Finanzierungsquellen	funding_opportunities
Stiftungszuschussprogramme	funding_opportunities
Corporate Sponsoring-Möglichkeiten	funding_opportunities
Startup-Finanzierungsprogramme	funding_opportunities
Technologieentwicklungsfinanzierung	funding_opportunities
Social-Impact-Finanzierung	funding_opportunities
Umweltfinanzierungsprogramme	funding_opportunities
Bildungsfinanzierungsinitiativen	funding_opportunities
Gesundheitsforschungsfinanzierung	funding_opportunities
Ingenieursprojektfinanzierung	funding_opportunities
Kunst- und Geisteswissenschaftsfinanzierung	funding_opportunities
Interdisziplinäre Finanzierungsprogramme	funding_opportunities
Kapazitätsaufbau-Finanzierung	funding_opportunities
Infrastrukturfinanzierungsmöglichkeiten	funding_opportunities
Ausrüstungsfinanzierungsprogramme	funding_opportunities
Ausbildungsfinanzierungsinitiativen	funding_opportunities
Konferenzfinanzierungsunterstützung	funding_opportunities
Veröffentlichungsfinanzierungsprogramme	funding_opportunities
Austauschprogramm-Finanzierung	funding_opportunities
Community-Engagement-Finanzierung	funding_opportunities
Outreach-Programm-Finanzierung	funding_opportunities
Auswirkungsmessungs-Finanzierung	funding_opportunities
Nachhaltigkeitsprojekt-Finanzierung	funding_opportunities
Rechtliche Partnerschaftsanforderungen	legal_compliance
Vertrags-Compliance-Richtlinien	legal_compliance
Regulatorische Compliance-Informationen	legal_compliance
Rechte am geistigen Eigentum	legal_compliance
Datenschutzanforderungen	legal_compliance
Datenschutzrichtlinien-Compliance	legal_compliance
Völkerrechtliche Überlegungen	legal_compliance
Exportkontrollbestimmungen	legal_compliance
Forschungsethik-Compliance	legal_compliance
Sicherheitsvorschriften-Compliance	legal_compliance
Umwelt-Compliance-Anforderungen	legal_compliance
Qualitätsstandards-Compliance	legal_compliance
Prüfungs- und Inspektionsverfahren	legal_compliance
Rechtliche Dokumentationsanforderungen	legal_compliance
Haftungs- und Versicherungsanforderungen	legal_compliance
Streitbeilegungsverfahren	legal_compliance
Vertragsverhandlungsrichtlinien	legal_compliance
Rechtliche Risikobewertung	legal_compliance
Compliance-Überwachungsverfahren	legal_compliance
Rechtsberatungsservices	legal_compliance
Regulatorische Berichtspflichten	legal_compliance
Compliance-Trainingsprogramme	legal_compliance
Rechtliche Dokumentationsvorlagen	legal_compliance
Vertragsmanagementverfahren	legal_compliance
Rechtliche Due-Diligence-Prozesse	legal_compliance
Compliance-Zertifizierungsanforderungen	legal_compliance
Rechtliche Partnerschaftsstrukturen	legal_compliance
Vertragsbeendigungsverfahren	legal_compliance
Rechtliche Haftungsüberlegungen	legal_compliance
Compliance-Prüfungsverfahren	legal_compliance
