text	label
How to establish partnership with HNU?	partnership_inquiry
Partnership opportunities available	partnership_inquiry
I want to partner with your university	partnership_inquiry
What are the partnership requirements?	partnership_inquiry
How to become a strategic partner?	partnership_inquiry
Partnership application process	partnership_inquiry
Types of partnerships offered	partnership_inquiry
Industry partnership opportunities	partnership_inquiry
Academic partnership programs	partnership_inquiry
Research partnership possibilities	partnership_inquiry
International partnership options	partnership_inquiry
Corporate partnership benefits	partnership_inquiry
Partnership agreement templates	partnership_inquiry
Partnership evaluation criteria	partnership_inquiry
Long-term partnership development	partnership_inquiry
Partnership renewal process	partnership_inquiry
Partnership fee structure	partnership_inquiry
Partnership compliance requirements	partnership_inquiry
Partnership performance metrics	partnership_inquiry
Partnership termination procedures	partnership_inquiry
Partnership legal requirements	partnership_inquiry
Partnership intellectual property rights	partnership_inquiry
Partnership confidentiality agreements	partnership_inquiry
Partnership liability considerations	partnership_inquiry
Partnership governance structure	partnership_inquiry
Partnership communication protocols	partnership_inquiry
Partnership reporting requirements	partnership_inquiry
Partnership audit procedures	partnership_inquiry
Partnership dispute resolution	partnership_inquiry
Partnership success stories	partnership_inquiry
Research collaboration opportunities	collaboration_opportunities
Joint project proposals	collaboration_opportunities
Collaborative research programs	collaboration_opportunities
Industry-academia collaboration	collaboration_opportunities
International collaboration projects	collaboration_opportunities
Cross-sector partnerships	collaboration_opportunities
Innovation collaboration initiatives	collaboration_opportunities
Technology transfer partnerships	collaboration_opportunities
Knowledge exchange programs	collaboration_opportunities
Collaborative funding opportunities	collaboration_opportunities
Joint research grants	collaboration_opportunities
Collaborative publications	collaboration_opportunities
Shared research facilities	collaboration_opportunities
Joint laboratory access	collaboration_opportunities
Collaborative research agreements	collaboration_opportunities
Multi-partner research consortiums	collaboration_opportunities
Collaborative innovation projects	collaboration_opportunities
Joint technology development	collaboration_opportunities
Collaborative training programs	collaboration_opportunities
Shared expertise initiatives	collaboration_opportunities
Joint conference organization	collaboration_opportunities
Collaborative workshops	collaboration_opportunities
Joint symposium planning	collaboration_opportunities
Collaborative knowledge creation	collaboration_opportunities
Joint research methodology	collaboration_opportunities
Collaborative data sharing	collaboration_opportunities
Joint intellectual property	collaboration_opportunities
Collaborative research ethics	collaboration_opportunities
Joint research supervision	collaboration_opportunities
Collaborative thesis projects	collaboration_opportunities
How to organize events at HNU?	event_planning
Event venue booking	event_planning
Conference facility rental	event_planning
Workshop space availability	event_planning
Event planning services	event_planning
Catering for events	event_planning
Audio-visual equipment rental	event_planning
Event security services	event_planning
Parking for event guests	event_planning
Event marketing support	event_planning
Event registration systems	event_planning
Corporate event hosting	event_planning
Academic conference organization	event_planning
Seminar room reservations	event_planning
Large venue availability	event_planning
Event setup requirements	event_planning
Event cleanup services	event_planning
Event insurance requirements	event_planning
Event permit procedures	event_planning
Event cost calculations	event_planning
Event equipment needs	event_planning
Event staff support	event_planning
Event technology requirements	event_planning
Event accessibility features	event_planning
Event recording services	event_planning
Event live streaming	event_planning
Event photography services	event_planning
Event promotional materials	event_planning
Event sponsorship opportunities	event_planning
Event feedback collection	event_planning
Vendor registration process	vendor_services
Supplier qualification requirements	vendor_services
Procurement procedures	vendor_services
Contract bidding process	vendor_services
Vendor payment terms	vendor_services
Service provider applications	vendor_services
Vendor compliance requirements	vendor_services
Supplier diversity programs	vendor_services
Vendor performance evaluation	vendor_services
Procurement policy information	vendor_services
Vendor invoice procedures	vendor_services
Service level agreements	vendor_services
Vendor onboarding process	vendor_services
Supplier audit requirements	vendor_services
Vendor insurance requirements	vendor_services
Procurement tender process	vendor_services
Vendor contract management	vendor_services
Supplier relationship management	vendor_services
Vendor dispute resolution	vendor_services
Procurement ethics guidelines	vendor_services
Vendor certification requirements	vendor_services
Supplier sustainability standards	vendor_services
Vendor data security requirements	vendor_services
Procurement risk management	vendor_services
Vendor performance metrics	vendor_services
Supplier quality standards	vendor_services
Vendor renewal procedures	vendor_services
Procurement transparency requirements	vendor_services
Vendor termination procedures	vendor_services
Supplier innovation programs	vendor_services
Joint research proposals	research_partnerships
Research funding opportunities	research_partnerships
Collaborative research grants	research_partnerships
Industry research partnerships	research_partnerships
Research facility access	research_partnerships
Joint PhD programs	research_partnerships
Research equipment sharing	research_partnerships
Joint research publications	research_partnerships
Research data sharing agreements	research_partnerships
Research collaboration frameworks	research_partnerships
Cross-disciplinary research	research_partnerships
International research partnerships	research_partnerships
Research commercialization opportunities	research_partnerships
Technology transfer programs	research_partnerships
Research spin-off support	research_partnerships
Joint research centers	research_partnerships
Research sabbatical programs	research_partnerships
Visiting researcher programs	research_partnerships
Research mentorship opportunities	research_partnerships
Research networking events	research_partnerships
Research conference partnerships	research_partnerships
Research workshop collaborations	research_partnerships
Joint research symposiums	research_partnerships
Research training partnerships	research_partnerships
Research capacity building	research_partnerships
Research infrastructure sharing	research_partnerships
Research methodology exchange	research_partnerships
Research best practices sharing	research_partnerships
Research impact assessment	research_partnerships
Research sustainability initiatives	research_partnerships
Student exchange programs	student_exchange
International student mobility	student_exchange
Exchange program requirements	student_exchange
Student placement opportunities	student_exchange
Exchange student support services	student_exchange
Academic credit transfer	student_exchange
Exchange program duration	student_exchange
Exchange student accommodation	student_exchange
Exchange program costs	student_exchange
Exchange student visas	student_exchange
Language requirements for exchange	student_exchange
Exchange program applications	student_exchange
Cultural exchange programs	student_exchange
Study abroad partnerships	student_exchange
Exchange student orientation	student_exchange
Exchange program evaluation	student_exchange
Exchange student mentoring	student_exchange
Exchange program coordination	student_exchange
International exchange agreements	student_exchange
Exchange student insurance	student_exchange
Exchange program monitoring	student_exchange
Exchange student integration	student_exchange
Exchange program quality assurance	student_exchange
Exchange student feedback	student_exchange
Exchange program sustainability	student_exchange
Exchange student career services	student_exchange
Exchange program alumni network	student_exchange
Exchange student research opportunities	student_exchange
Exchange program partnerships	student_exchange
Exchange student success stories	student_exchange
Campus facility rental	facility_rental
Conference room booking	facility_rental
Auditorium rental availability	facility_rental
Laboratory space rental	facility_rental
Sports facility booking	facility_rental
Equipment rental services	facility_rental
Venue rental pricing	facility_rental
Facility booking procedures	facility_rental
Event space availability	facility_rental
Meeting room reservations	facility_rental
Classroom rental options	facility_rental
Facility usage policies	facility_rental
Rental agreement terms	facility_rental
Facility security deposits	facility_rental
Rental cancellation policies	facility_rental
Facility maintenance services	facility_rental
Rental equipment inventory	facility_rental
Facility accessibility features	facility_rental
Rental insurance requirements	facility_rental
Facility setup services	facility_rental
Rental payment terms	facility_rental
Facility cleaning services	facility_rental
Rental duration limits	facility_rental
Facility capacity information	facility_rental
Rental booking timeline	facility_rental
Facility technical support	facility_rental
Rental customer services	facility_rental
Facility safety requirements	facility_rental
Rental damage policies	facility_rental
Facility availability calendar	facility_rental
Technology licensing opportunities	technology_transfer
Intellectual property transfer	technology_transfer
Innovation commercialization	technology_transfer
Patent licensing agreements	technology_transfer
Technology evaluation services	technology_transfer
Research commercialization support	technology_transfer
Startup incubation programs	technology_transfer
Technology scouting services	technology_transfer
Innovation partnership programs	technology_transfer
Technology development funding	technology_transfer
Market research for technologies	technology_transfer
Technology demonstration opportunities	technology_transfer
Proof of concept funding	technology_transfer
Technology valuation services	technology_transfer
Licensing negotiation support	technology_transfer
Technology due diligence	technology_transfer
Innovation ecosystem partnerships	technology_transfer
Technology transfer training	technology_transfer
Intellectual property protection	technology_transfer
Technology marketing support	technology_transfer
Innovation competition programs	technology_transfer
Technology showcase events	technology_transfer
Industry technology needs	technology_transfer
Technology readiness assessment	technology_transfer
Commercialization strategy development	technology_transfer
Technology transfer success stories	technology_transfer
Innovation impact measurement	technology_transfer
Technology partnership agreements	technology_transfer
Innovation funding opportunities	technology_transfer
Technology transfer best practices	technology_transfer
University general information	public_information
Campus tour requests	public_information
Public relations inquiries	public_information
Media contact information	public_information
University statistics	public_information
Annual report access	public_information
University mission statement	public_information
Academic program information	public_information
Faculty expertise directory	public_information
University news updates	public_information
Press release information	public_information
University achievements	public_information
Accreditation information	public_information
University rankings	public_information
Alumni success stories	public_information
University history information	public_information
Campus map and directions	public_information
Public lecture series	public_information
Community engagement programs	public_information
University social responsibility	public_information
Sustainability initiatives	public_information
University strategic plan	public_information
Quality assurance information	public_information
University governance structure	public_information
Public access policies	public_information
University transparency reports	public_information
Community partnership programs	public_information
Public service announcements	public_information
University branding guidelines	public_information
External communication policies	public_information
Alumni networking opportunities	alumni_relations
Alumni mentorship programs	alumni_relations
Alumni career services	alumni_relations
Alumni events calendar	alumni_relations
Alumni donation opportunities	alumni_relations
Alumni volunteer programs	alumni_relations
Alumni directory access	alumni_relations
Alumni benefit programs	alumni_relations
Alumni continuing education	alumni_relations
Alumni research collaboration	alumni_relations
Alumni success story sharing	alumni_relations
Alumni newsletter subscription	alumni_relations
Alumni social media groups	alumni_relations
Alumni professional development	alumni_relations
Alumni entrepreneurship support	alumni_relations
Alumni industry connections	alumni_relations
Alumni international network	alumni_relations
Alumni scholarship programs	alumni_relations
Alumni governance participation	alumni_relations
Alumni advisory board opportunities	alumni_relations
Alumni reunion planning	alumni_relations
Alumni recognition programs	alumni_relations
Alumni feedback collection	alumni_relations
Alumni partnership opportunities	alumni_relations
Alumni knowledge sharing	alumni_relations
Alumni community building	alumni_relations
Alumni legacy programs	alumni_relations
Alumni impact measurement	alumni_relations
Alumni engagement strategies	alumni_relations
Alumni relationship management	alumni_relations
Professional consultation services	consultation_services
Expert advisory services	consultation_services
Technical consultation offerings	consultation_services
Industry analysis services	consultation_services
Market research consultation	consultation_services
Technology assessment services	consultation_services
Business strategy consultation	consultation_services
Innovation consulting services	consultation_services
Research methodology consultation	consultation_services
Policy analysis services	consultation_services
Risk assessment consultation	consultation_services
Quality assurance consultation	consultation_services
Process improvement services	consultation_services
Sustainability consulting	consultation_services
Digital transformation advice	consultation_services
Change management consultation	consultation_services
Training and development services	consultation_services
Feasibility study services	consultation_services
Due diligence consultation	consultation_services
Compliance consulting services	consultation_services
Performance evaluation services	consultation_services
Strategic planning consultation	consultation_services
Project management services	consultation_services
Knowledge transfer services	consultation_services
Best practices consultation	consultation_services
Benchmarking services	consultation_services
Evaluation and assessment services	consultation_services
Advisory committee participation	consultation_services
Expert witness services	consultation_services
Professional certification support	consultation_services
Grant funding opportunities	funding_opportunities
Research funding programs	funding_opportunities
Partnership funding schemes	funding_opportunities
Innovation funding initiatives	funding_opportunities
Collaborative project funding	funding_opportunities
International funding programs	funding_opportunities
Government funding opportunities	funding_opportunities
Private funding sources	funding_opportunities
Foundation grant programs	funding_opportunities
Corporate sponsorship opportunities	funding_opportunities
Startup funding programs	funding_opportunities
Technology development funding	funding_opportunities
Social impact funding	funding_opportunities
Environmental funding programs	funding_opportunities
Educational funding initiatives	funding_opportunities
Healthcare research funding	funding_opportunities
Engineering project funding	funding_opportunities
Arts and humanities funding	funding_opportunities
Interdisciplinary funding programs	funding_opportunities
Capacity building funding	funding_opportunities
Infrastructure funding opportunities	funding_opportunities
Equipment funding programs	funding_opportunities
Training funding initiatives	funding_opportunities
Conference funding support	funding_opportunities
Publication funding programs	funding_opportunities
Exchange program funding	funding_opportunities
Community engagement funding	funding_opportunities
Outreach program funding	funding_opportunities
Impact measurement funding	funding_opportunities
Sustainability project funding	funding_opportunities
Partnership legal requirements	legal_compliance
Contract compliance guidelines	legal_compliance
Regulatory compliance information	legal_compliance
Intellectual property rights	legal_compliance
Data protection requirements	legal_compliance
Privacy policy compliance	legal_compliance
International law considerations	legal_compliance
Export control regulations	legal_compliance
Research ethics compliance	legal_compliance
Safety regulation compliance	legal_compliance
Environmental compliance requirements	legal_compliance
Quality standards compliance	legal_compliance
Audit and inspection procedures	legal_compliance
Legal documentation requirements	legal_compliance
Liability and insurance requirements	legal_compliance
Dispute resolution procedures	legal_compliance
Contract negotiation guidelines	legal_compliance
Legal risk assessment	legal_compliance
Compliance monitoring procedures	legal_compliance
Legal advisory services	legal_compliance
Regulatory reporting requirements	legal_compliance
Compliance training programs	legal_compliance
Legal documentation templates	legal_compliance
Contract management procedures	legal_compliance
Legal due diligence processes	legal_compliance
Compliance certification requirements	legal_compliance
Legal partnership structures	legal_compliance
Contract termination procedures	legal_compliance
Legal liability considerations	legal_compliance
Compliance audit procedures	legal_compliance
